{
    "Epic-F0":  100,
    "Epic-E1":  101,
    "Epic-E2":  102,
    "Epic-E3":  103,
    "Epic-E4":  104,
    "Epic-E5":  105,
    "Epic-E6":  106,
    "F0-S1":  107,
    "F0-S2":  108,
    "F0-S3":  109,
    "F0-S4":  110,
    "E1-S1":  111,
    "E1-S2":  112,
    "E1-S3":  113,
    "E1-S4":  114,
    "E1-S5":  115,
    "E1-S6":  116,
    "E2-S1":  117,
    "E2-S2":  118,
    "E2-S3":  119,
    "E2-S4":  120,
    "E2-S5":  121,
    "E2-S6":  122,
    "E2-S7":  123,
    "E2-S8":  124,
    "E3-S1":  125,
    "E3-S2":  126,
    "E3-S3":  127,
    "E3-S4":  128,
    "E3-S5":  129,
    "E3-S6":  130,
    "E4-S1":  131,
    "E4-S2":  132,
    "E4-S3":  133,
    "E4-S4":  134,
    "E4-S5":  135,
    "E5-S1":  136,
    "E5-S2":  137,
    "E5-S3":  138,
    "E5-S4":  139,
    "E5-S5":  140,
    "E6-S1":  141,
    "E6-S2":  142,
    "E6-S3":  143,
    "E6-S4":  144,
    "E6-S5":  145,
    "E6-S6":  146
}
